5 9
*****
*..e*
*.***
*...*
*****
*...*
*.***
*..o*
*****
