10 10
**********
*o*...*..*
*.*.*.*..*
*.*.*.*..*
*.*.*....*
*.*.****.*
*.*.*....*
*.*.*.****
*...*...e*
**********
