20 20
********************
********************
****......*******e**
**o..****.*******.**
*********.*******.**
**........*******.**
**.******.**...**.**
**.**.....**.*.**.**
**.**.******.*.**.**
*****........*.**.**
**************.**.**
*********.****.**.**
*********.****.**.**
*****.....****.**.**
**....***......**.**
**.*********.****.**
**.**************.**
**................**
********************
********************
