15 10
***************
*o.........****
*******.*******
*******.*******
***.......*****
*****.*********
*****.*********
*****.....*****
*********...e**
***************
